1111111111111
1CE1000000001
1P00011111001
10001100K0001
1111111111111