1111111111111
1CE1000000001
1P00011111001
100011000P001
1111111111111