1111111111111
1CE1000000001
1P00011111001
1000110000001
1111111111110